00000000003000000000
00000000034300000000
00000000340430000000
00002210034300221000
00021021003002102100
00210002100021000210
00210002100021000210
00210002100021000210
00210002100021000210
00210002100021000210
00210002100021000210
00210002100021000210
00210000211210000210
02100400022100040021
00000000000000000000
00000000000000000000