00003000000000030000
00003111111111530000
00010300000005651000
00100350000000500100
01000565444443000010
10000050000003400001
00000403000030040000
00004003000030004000
30040000300300000503
03305000300300005650
00456500222200033500
00405332000023300400
00400020000002000400
05450520000002505450
32323230000003232323	
00000000000000000000