00000000000000000000
00010000000111111000
00111000001000000100
00010000010002200010
00000000001000000100
00000000000111111000
00011111100000000100
00100000010000001110
01000220001000000100
00100000010000000000
00011111100111111000
00000000001000000100
00001000010002200010
00011100001000000100
00001000000111111000
00000000000000000000