00000000000000000000
00000022002200020200
00000022002200035300
00000033553300020200
00000033553300000000
00000022002200000000
02020022002200002020
03530000000000003530
02020020200000002020
40000035300000000004
04000020200202000040
00400000000353000400
00040000000202004000
00004000000000040000
00000444444444400000
00000000000000000000