00000000000000000000
00000000000000000000
00000000000000000000
00000000000000000000
00001111111111110000
00001000000000010000
00001022222222010000
00001000000000010000
00001111111111110000
00000000000000000000
00000000000000000000
00000000000000000000
00111100000000111100
01111110000001111110
00000000000000000000
00000000000000000000