00000000000000000000
00101030101010101010
01010101010101010300
00301010101010101010
01010103010101010100
00101010101010103010
01030101010101010100
00101010101010101010
01010101010301010100
00101010101010101010
01010301010101010100
00101010101010103010
01010101010101010100
00000000000000000000
11111111111111111111
22222222222222222222
