00000000000000000000
00000000000000000000
00000000000000000000
00031000031000000310
00323200323200003200
03100313100310031000
03200003200000320000
03100003131003100000
03200003323203200000
03100003100313131000
03202323200323333320
00313100313100031000
00032000032000032000
00000000000000000000
00000000000000000000
00000000000000000000