00000000000000000000
00000000000000000000
00000000000000000000
20002000200020002000
02020202020202020202
00200020002000200020
00100010001000100010
01010101010101010101
10001000100010001000
30003000300030003000
03030303030303030303
00300030003000300030
00400040004000400040
04040404040404040404
40004000400040004000
00000000000000000000