00100000000000000100
01110000111100001110
00100001111110000100
00000011122111000000
00000111222211100000
00001112233221110000
00011122333322111000
00111223333332211100
00011122333322111000
00001112233321110000
00000111222211100000
00000011122111000000
00000001111110000000
00100000111100000100
01110000000000001110
00100000000000000100