00002003004040030020
12021030040604003002
21202103004040030021
00120210300400300210
03012021030003002101
30301202103030021012
00030120210300210120
04003012021002101200
40400301202121012003
06040030120210120030
40400300210101200300
04003002001012003004
00030020010120030040
30300200100200300406
03002001010020030040
00020010001002003004